####################################################################################################
####################################################################################################
####################################################################################################
####################################################################################################
####################################################################################################
####################################################################################################
####################################################################################################
######################################                       #######################################
######################################                       #######################################
######################################                       #######################################
######################################                       #######################################
######################################                       #######################################
######################################                       #######################################
######################################                       #######################################
#######################################                     ########################################
########################################                   #########################################
###########################################             ############################################
###########################################             ############################################
###########################################             ############################################
###########################################             ############################################
###########################################             ############################################
###########################################             ############################################
###########################################             ############################################
###########################################             ############################################
###########################################             ############################################
###########################################             ############################################
###########################################             ############################################
###########################################             ############################################
###########################################             ############################################
###########################################             ############################################
###########################################             ############################################
###########################################             ############################################
###########################################             ############################################
########################################                   #########################################
#######################################                     ########################################
######################################                       #######################################
######################################                       #######################################
######################################                       #######################################
######################################                       #######################################
######################################                       #######################################
######################################                       #######################################
######################################                       #######################################
####################################################################################################
####################################################################################################
####################################################################################################
####################################################################################################
####################################################################################################
####################################################################################################
####################################################################################################
####################################################################################################

